1111111111111
10010000000C1
1000C11111001
1P00C11E01001
1111111111111